a ...#... c
R ...#...
###########
a ....... b
###########
! c ..... b
###########