##!##   .##
#R.a   #a #
#. ##  #.
#M  #  #  #
# b.#b    M
##### ##  #