!##########
M 4 M#    #
###########
#R.#1..#..#
#a
#####M## a#