###########
..a   M   #
###########
#R. #. #. #
# 1     1 M
     4
M !## ##  M
####M#M# a#