###########
..a   M   #
###########
..b   M   #
###########
R   ab    !
  1 11 1  M
...........
###########