#.1.#.1.#.1.#
R   2 d 2  .b
  2 2 . 2 2 .
 c###.M.###a
##MMM#M#MMM##
 a###.M.###c
. 2 2 . 2 2
d.  2 b 2   !
#.1.#.1.#.1.#