a............
#11#######11#
2    #c#c   2
M    #R#    M
M    # #    M
M    #!#    M
2   b#b#    2
#11#######11#
............a