###########
..a  M c..#
###########
..c M  b..#
###########
R   ab    !
  1 11 1  M
...........
###########